11111111111111111111
100T00T00000C0000001
1T000P000C00000000E1
100000T00T00000C0001
11111111111111111111
